00 04 00 04 00 04 00 04 00 04 00 04 00 04 00 04 00 04 00 04 00 04
04 00 04 00 04 00 04 00 04 00 04 00 04 00 04 00 04 00 04 00 04 00
00 03 00 03 00 03 00 03 00 03 00 03 00 03 00 03 00 03 00 03 00 03
03 00 03 00 03 00 03 00 03 00 03 00 03 00 03 00 03 00 03 00 03 00
00 02 00 02 00 02 00 02 00 02 00 02 00 02 00 02 00 02 00 02 00 02
02 00 02 00 02 00 02 00 02 00 02 00 02 00 02 00 02 00 02 00 02 00
00 01 00 01 00 01 00 01 00 01 00 01 00 01 00 01 00 01 00 01 00 01
01 00 01 00 01 00 01 00 01 00 01 00 01 00 01 00 01 00 01 00 01 00