00 00 00 04 04 04 04 04 04 04 04 04 04 04 04 04 04 04 04 00 00 00
00 00 00 04 04 04 04 04 04 04 04 04 04 04 04 04 04 04 04 00 00 00
00 00 00 00 00 00 00 00 00 00 00 00 00 00 00 00 00 00 00 00 00 00
00 00 00 00 00 00 00 00 00 00 00 00 00 00 00 00 00 00 00 00 00 00
00 00 00 00 00 00 00 00 00 00 00 00 00 00 00 00 00 00 00 00 00 00
00 00 00 00 00 00 00 00 00 00 00 00 00 00 00 00 00 00 00 00 00 00
00 00 00 01 01 01 01 01 01 01 01 01 01 01 01 01 01 01 01 00 00 00
00 00 00 01 01 01 01 01 01 01 01 01 01 01 01 01 01 01 01 00 00 00